abraham lincoln	resources/extractedWiki/AA/wiki_02
altweibersommer	resources/extractedWiki/AA/wiki_02
astana	resources/extractedWiki/AA/wiki_02
angela merkel	resources/extractedWiki/AA/wiki_02
alicia silverstone	resources/extractedWiki/AA/wiki_02
al-biruni	resources/extractedWiki/AA/wiki_02
ankara	resources/extractedWiki/AA/wiki_02
atheismus	resources/extractedWiki/AA/wiki_02
anna seghers	resources/extractedWiki/AA/wiki_02
atmosphäre (astronomie)	resources/extractedWiki/AA/wiki_02
arvo pärt	resources/extractedWiki/AA/wiki_02
afghanistan	resources/extractedWiki/AA/wiki_02
atonale musik	resources/extractedWiki/AA/wiki_02
akeleien	resources/extractedWiki/AA/wiki_02
aleister crowley	resources/extractedWiki/AA/wiki_02
aikidō	resources/extractedWiki/AA/wiki_02
alan smithee	resources/extractedWiki/AA/wiki_00
actinium	resources/extractedWiki/AA/wiki_00
ang lee	resources/extractedWiki/AA/wiki_00
anschluss (soziologie)	resources/extractedWiki/AA/wiki_00
aussagenlogik	resources/extractedWiki/AA/wiki_00
liste von autoren/a	resources/extractedWiki/AA/wiki_00
liste von autoren/h	resources/extractedWiki/AA/wiki_00
liste von autoren/c	resources/extractedWiki/AA/wiki_00
liste von autoren/i	resources/extractedWiki/AA/wiki_00
liste von autoren/k	resources/extractedWiki/AA/wiki_00
liste von autoren/j	resources/extractedWiki/AA/wiki_00
liste von autoren/v	resources/extractedWiki/AA/wiki_00
liste von autoren/g	resources/extractedWiki/AA/wiki_00
liste von autoren/w	resources/extractedWiki/AA/wiki_00
liste von autoren/b	resources/extractedWiki/AA/wiki_00
liste von autoren/d	resources/extractedWiki/AA/wiki_00
liste von autoren/s	resources/extractedWiki/AA/wiki_00
liste von autoren/t	resources/extractedWiki/AA/wiki_00
liste von autoren/m	resources/extractedWiki/AA/wiki_00
liste von autoren/o	resources/extractedWiki/AA/wiki_00
liste von autoren/f	resources/extractedWiki/AA/wiki_00
liste von autoren/e	resources/extractedWiki/AA/wiki_00
liste von autoren/l	resources/extractedWiki/AA/wiki_00
liste von autoren/n	resources/extractedWiki/AA/wiki_00
liste von autoren/p	resources/extractedWiki/AA/wiki_00
liste von autoren/q	resources/extractedWiki/AA/wiki_00
liste von autoren/r	resources/extractedWiki/AA/wiki_00
liste von autoren/u	resources/extractedWiki/AA/wiki_00
liste von autoren/y	resources/extractedWiki/AA/wiki_00
liste von autoren/z	resources/extractedWiki/AA/wiki_00
anthony minghella	resources/extractedWiki/AA/wiki_00
us-amerikanischer film	resources/extractedWiki/AA/wiki_00
vorsätze für maßeinheiten	resources/extractedWiki/AA/wiki_00
abkürzungen/gesetze und recht	resources/extractedWiki/AA/wiki_00
liste von abkürzungen (computer)	resources/extractedWiki/AA/wiki_00
liste von unternehmen mit namensherkunftserklärungen	resources/extractedWiki/AA/wiki_00
iso 4217	resources/extractedWiki/AA/wiki_00
achsensprung (film)	resources/extractedWiki/AA/wiki_00
alfred hitchcock	resources/extractedWiki/AA/wiki_00
auteur-theorie	resources/extractedWiki/AA/wiki_00
aki kaurismäki	resources/extractedWiki/AA/wiki_00
anime	resources/extractedWiki/AA/wiki_00
actionfilm	resources/extractedWiki/AA/wiki_00
al pacino	resources/extractedWiki/AA/wiki_00
alkohole	resources/extractedWiki/AA/wiki_00
the visitors	resources/extractedWiki/AA/wiki_00
aluminium	resources/extractedWiki/AA/wiki_00
antimon	resources/extractedWiki/AA/wiki_00
argon	resources/extractedWiki/AA/wiki_00
arsen	resources/extractedWiki/AA/wiki_00
astat	resources/extractedWiki/AA/wiki_00
alkalimetalle	resources/extractedWiki/AA/wiki_00
actinoide	resources/extractedWiki/AA/wiki_00
americium	resources/extractedWiki/AA/wiki_00
atom	resources/extractedWiki/AA/wiki_00
arzt	resources/extractedWiki/AA/wiki_00
anthropologie	resources/extractedWiki/AA/wiki_01
alexander der große	resources/extractedWiki/AA/wiki_01
antike	resources/extractedWiki/AA/wiki_01
anthony hope	resources/extractedWiki/AA/wiki_01
ångström (einheit)	resources/extractedWiki/AA/wiki_01
ampere	resources/extractedWiki/AA/wiki_01
acre	resources/extractedWiki/AA/wiki_01
apostilb	resources/extractedWiki/AA/wiki_01
ar (einheit)	resources/extractedWiki/AA/wiki_01
arbeit (sozialwissenschaften)	resources/extractedWiki/AA/wiki_01
atomare masseneinheit	resources/extractedWiki/AA/wiki_01
anglizismus	resources/extractedWiki/AA/wiki_01
astronom	resources/extractedWiki/AA/wiki_01
alan turing	resources/extractedWiki/AA/wiki_01
archäologie	resources/extractedWiki/AA/wiki_01
american standard code for information interchange	resources/extractedWiki/AA/wiki_01
außenbandruptur des oberen sprunggelenkes	resources/extractedWiki/AA/wiki_01
alphabet	resources/extractedWiki/AA/wiki_01
arthur harris	resources/extractedWiki/AA/wiki_01
arthur wellesley, 1. duke of wellington	resources/extractedWiki/AA/wiki_01
astronomie	resources/extractedWiki/AA/wiki_01
angelina jolie	resources/extractedWiki/AA/wiki_01
archimedes	resources/extractedWiki/AA/wiki_01
aristoteles	resources/extractedWiki/AA/wiki_01
germanen	resources/extractedWiki/AB/wiki_11
bakterien	resources/extractedWiki/AB/wiki_11
germane	resources/extractedWiki/AB/wiki_11
bauhaus-archiv	resources/extractedWiki/AB/wiki_11
walter gropius	resources/extractedWiki/AB/wiki_11
prim	resources/extractedWiki/AB/wiki_11
organismus	resources/extractedWiki/AB/wiki_11
halbton	resources/extractedWiki/AB/wiki_11
ganzton	resources/extractedWiki/AB/wiki_11
zenit	resources/extractedWiki/AB/wiki_11
lineare algebra	resources/extractedWiki/AB/wiki_11
gram-schmidtsches orthogonalisierungsverfahren	resources/extractedWiki/AB/wiki_11
gletscher	resources/extractedWiki/AB/wiki_11
neutrino	resources/extractedWiki/AB/wiki_11
karl schwarzschild	resources/extractedWiki/AB/wiki_11
kartoffel	resources/extractedWiki/AB/wiki_11
implementierung	resources/extractedWiki/AB/wiki_11
schelfeis	resources/extractedWiki/AB/wiki_11
terz	resources/extractedWiki/AB/wiki_11
warlord	resources/extractedWiki/AB/wiki_11
lobo (dc comics)	resources/extractedWiki/AB/wiki_11
dsa	resources/extractedWiki/AB/wiki_11
faro	resources/extractedWiki/AB/wiki_11
nachrichtendienst	resources/extractedWiki/AB/wiki_11
secret service	resources/extractedWiki/AB/wiki_11
heidelberg	resources/extractedWiki/AB/wiki_11
pforzheim	resources/extractedWiki/AB/wiki_11
antiteilchen	resources/extractedWiki/AB/wiki_11
wiesloch	resources/extractedWiki/AB/wiki_11
tanach	resources/extractedWiki/AB/wiki_11
quinte	resources/extractedWiki/AB/wiki_11
sext	resources/extractedWiki/AB/wiki_11
septime	resources/extractedWiki/AB/wiki_11
oktave (begriffsklärung)	resources/extractedWiki/AB/wiki_11
tongeschlecht	resources/extractedWiki/AB/wiki_11
moll	resources/extractedWiki/AB/wiki_11
quint	resources/extractedWiki/AB/wiki_11
pythagoreische stimmung	resources/extractedWiki/AB/wiki_10
dorf	resources/extractedWiki/AB/wiki_10
intervall (musik)	resources/extractedWiki/AB/wiki_10
intervall (mathematik)	resources/extractedWiki/AB/wiki_10
zwickau	resources/extractedWiki/AB/wiki_10
giuseppe peano	resources/extractedWiki/AB/wiki_10
hurenkind und schusterjunge	resources/extractedWiki/AB/wiki_10
tag der deutschen einheit	resources/extractedWiki/AB/wiki_10
aufstand vom 17. juni 1953	resources/extractedWiki/AB/wiki_10
nationalfeiertag	resources/extractedWiki/AB/wiki_10
mangos	resources/extractedWiki/AB/wiki_10
sekte	resources/extractedWiki/AB/wiki_10
komet	resources/extractedWiki/AB/wiki_10
insel	resources/extractedWiki/AB/wiki_10
grundnahrungsmittel	resources/extractedWiki/AB/wiki_10
quark (physik)	resources/extractedWiki/AB/wiki_10
milcherzeugnis	resources/extractedWiki/AB/wiki_10
robert f. kennedy	resources/extractedWiki/AB/wiki_10
tonleiter	resources/extractedWiki/AB/wiki_10
dur	resources/extractedWiki/AB/wiki_10
kirchentonart	resources/extractedWiki/AB/wiki_10
retroviren	resources/extractedWiki/AB/wiki_10
bundespräsident (deutschland)	resources/extractedWiki/AB/wiki_10
bundespräsident (schweiz)	resources/extractedWiki/AB/wiki_10
bundespräsident (österreich)	resources/extractedWiki/AB/wiki_10
eisberg	resources/extractedWiki/AB/wiki_10
bröhan-museum	resources/extractedWiki/AB/wiki_10
schottland	resources/extractedWiki/AB/wiki_10
tropen	resources/extractedWiki/AB/wiki_10
general	resources/extractedWiki/AB/wiki_10
hannah arendt	resources/extractedWiki/AB/wiki_09
reise	resources/extractedWiki/AB/wiki_09
pharao	resources/extractedWiki/AB/wiki_09
aeneas	resources/extractedWiki/AB/wiki_09
odysseus	resources/extractedWiki/AB/wiki_09
epos	resources/extractedWiki/AB/wiki_09
odyssee	resources/extractedWiki/AB/wiki_09
charlotte corday	resources/extractedWiki/AB/wiki_09
balkankriege	resources/extractedWiki/AB/wiki_09
berlin-friedenau	resources/extractedWiki/AB/wiki_09
mohammed (name)	resources/extractedWiki/AB/wiki_09
aus (stamm)	resources/extractedWiki/AB/wiki_09
quraisch	resources/extractedWiki/AB/wiki_09
hausa	resources/extractedWiki/AB/wiki_09
lateinisches alphabet	resources/extractedWiki/AB/wiki_09
islamischer kalender	resources/extractedWiki/AB/wiki_09
arabischer name	resources/extractedWiki/AB/wiki_09
utopia (roman)	resources/extractedWiki/AB/wiki_09
dystopie	resources/extractedWiki/AB/wiki_09
reine stimmung	resources/extractedWiki/AB/wiki_09
sprachfamilie	resources/extractedWiki/AB/wiki_09
rhesusfaktor	resources/extractedWiki/AB/wiki_09
satellit	resources/extractedWiki/AB/wiki_09
jupiter	resources/extractedWiki/AB/wiki_09
hans von kulmbach	resources/extractedWiki/AB/wiki_09
oberon	resources/extractedWiki/AB/wiki_09
alan alexander milne	resources/extractedWiki/AB/wiki_09
wolf von niebelschütz	resources/extractedWiki/AB/wiki_09
intrusion detection system	resources/extractedWiki/AB/wiki_09
firewall	resources/extractedWiki/AB/wiki_09
fette	resources/extractedWiki/AB/wiki_09
nordamerika	resources/extractedWiki/AB/wiki_09
franken	resources/extractedWiki/AB/wiki_09
helena (mythologie)	resources/extractedWiki/AB/wiki_09
helena	resources/extractedWiki/AB/wiki_09
laborbedingungen	resources/extractedWiki/AB/wiki_09
